===================================================================================================
===================================================================================================
=###############=##########=№№№№№№№№№№№№№№№№№№№№№№№№№№№№№№=###=###########=#######################=
=###############=##########=№№№№№№№№№№№№№№№№№№№№№№№№№№№№№№=###=###########=#######################=
=###############=##########=№№№№№№№№№№№№№№№№№№№№№№№№№№№№№№=###=###########=====########=##########=
=###############=##########=№№№№№№№№№№№№№№№№№№№№№№№№№№№№№№=###=###############=########=##########=
=###############=##########=№№№№№№№№№№№№№№№№№№№№№№№№№№№№№№=###=###############=########=##########=
=###############=##########=№№№№№№№№№№№№№№№№№№№№№№№№№№№№№№=###=###############=########=##########=
=###############=##########=№№№№№№№№№№№№№№№№№№№№№№№№№№№№№№=###=###############=########=##########=
=###############=##########=№№№№№№№№№№№№№№№№№№№№№№№№№№№№№№=###=###############=########============
=######=########=##########=########№№№№№№№№№№№№№№№№№№№№№№=###=###############=###################=
=######=########=##########=########№№№№№№№№№№№№№№№№№№№№№№=###=###############=###################=
=######=########=##########=########№№№№№№№№№№№№№№№№№№№№№№=###=###############=###################=
=######=########=##########=########№№№№№№№№№№№№№№№№№№№№№№=====###############=###################=
=######=########=##########=############№№№№№№№№№№№№№№№№№№=###=###############=###################=
=######=########=##########=############№№№№№№№№№№№№№№№№№№=###=###############=====================
=######==========##########=############№№№№№№№№№№№№№№№№№№=###=#####################=#############=
=###############=##########====================================#####################=#############=
=###############=########################======================#####################=#############=
=###############=########################======================#####################=#############=
=###############=########################===========@==========#####################=#############=
=###############=########################======================#####################=#############=
=###############=########################======================########==============#############=
=###############=########################======================###################################=
=###############=########################======================###################################=
=###############=########################==================###=###################################=
=###############=########################==================###=###################################=
=###############=########################==================###=###################################=
=###############=########################==========================================================
=##=========================================###=########=#######=#####№№№№№№№№№№№№№№№№№№№№№№№№№№№==
=##====##########=#######################===###=########=#######=#####№№№№№№№№№№№№№№№№№№№№№№№№№===#
=#####=##########=#########=================###=########=#######=#####№№№№№№№№№№№№№№№№№№№№№№№===###
=#####=##########=#######################===###==========#######=#####№№№№№№№№№№№№№№№№№№№№№===#####
==#####=##########=#######################===###==========#######=#####№№№№№№№№№№№№№№№№№№№№№===#####
==#####=##########=#######################===###==========#######=#####№№№№№№№№№№№№№№№№№№№№№===#####
==#####=##########=#######################===###==========#######=#####№№№№№№№№№№№№№№№№№№№№№===#####
==#####=##########=#######################===###==========#######=#####№№№№№№№№№№№№№№№№№№№№№===#####
==#####=##########=#######################===###==========#######=#####№№№№№№№№№№№№№№№№№№№№№===#####
==#####=##########=#######################===###==========#######=#####№№№№№№№№№№№№№№№№№№№№№===#####
==#####=##########=#######################===###==========#######=#####№№№№№№№№№№№№№№№№№№№№№===#####
==#####=##########=#######################===###==========#######=#####№№№№№№№№№№№№№№№№№№№№№===#####
==#####=##########=#######################===###==========#######=#####№№№№№№№№№№№№№№№№№№№№№===#####
=
=
=
=
=
=
=
===================================================================================================